1 1 1 1 1 1 1 1 1 1 1 1 1 1 1 1 1 1
1 0 0 0 2 0 0 0 3 0 0 0 0 0 0 0 0 1
1 0 a 0 0 0 0 0 3 0 9 9 0 9 0 9 9 1
1 2 2 2 2 0 0 0 3 0 8 0 0 0 0 0 0 1
1 0 0 0 0 0 0 0 3 0 8 0 0 0 0 0 0 1
1 0 0 0 0 0 0 0 3 0 8 0 0 0 0 0 0 1
1 5 0 4 4 4 0 3 3 0 8 0 0 0 0 0 0 1
1 0 0 0 6 0 0 0 0 0 8 0 0 0 0 0 0 1
1 0 0 0 6 0 0 0 7 7 7 0 0 0 0 0 0 1
1 0 0 0 6 0 0 0 7 0 0 0 0 10 0 0 0 1
1 0 0 0 6 7 7 7 7 0 0 0 10 10 10 0 0 1
1 0 0 0 0 0 0 0 0 0 0 0 0 10 0 0 0 1
1 0 0 0 0 0 0 0 0 0 0 0 0 0 0 0 0 1
1 1 1 1 1 1 1 1 1 1 1 1 1 1 1 1 1 1
